..###...#####..
.#...###.....#.
#..#....###..#.
#..###..#...##.
#.#...#.@.#...#
#..#.#...###..#
##.#...#...#..#
..###..#..#..##
.#...##..##...#
.#.#....#...#.#
#...#######..#.
#..#.....#.#..#
.#..##.#...##.#
..##....##..#.#
#####....######
