###..######.....
#....#....###..
#..##..##...#..
#.##......##..#
#...###..###..#
#.#....@....#.#
#...##..##...##
#.##......##..#
#..##..##...#..
#....#....###..
###..######....
....#..#.......
.#..####..#..##
.#.#....#.#..##
###......######
