#####..##..####
#...#......#..#
#.##.##..##.#.#
#.#..#....#..##
#.#.##.##.##.#.
#..#......#..#.
.#.#..#@#..#.#.
.#.##.#..##.#..
#..#......#..#.
#.##.##..##.#.#
#.#..#....#..##
#.#.##.##.##.#.
#...#......#..#
#####..##..####
######....#####
