#######..######
#.....#..#....#
#.###.####.##.#
#.#.#......#..#
#.#.##.##.##.#.
#..#......#..#.
.#.#..#@#..#.#.
.#.##.#..##.#..
#..#......#..#.
#.#.##.##.##.#.
#.#.#......#..#
#.###.####.##.#
#.....#..#....#
#######..######
######....#####
